1111111111111111111111111
10C00000000000C000000C0E1
100000000000C000011000001
1E0000000000000000C000001
1000000000011C000000000E1
100C00000P111100C000C0001
1111111111111111111111111