111111111
10000C001
100111001
1EP111011
100111001
1011111C1
111111111