11111111111111111111111111111111
10C00000000000C000000C0000000001
100P000000C000000110000000000001
10E00000C000000000C0000000000001
11111111111111111111111111111111
